76, 76, 76, 85, 73, 64, 64, 64, 65, 0, 0, 0, 0
76, 76, 76, 76, 76, 76, 86, 76, 77, 0, 0, 0, 0
76, 76, 76, 76, 61, 88, 88, 88, 89, 0, 0, 0, 0
76, 86, 76, 76, 77, 0, 0, 0, 0, 0, 0, 0, 0
76, 76, 61, 88, 89, 0, 0, 0, 0, 0, 0, 0, 0
76, 76, 77, 0, 0, 0, 0, 0, 0, 0, 0, 0, 0
85, 76, 77, 0, 0, 0, 0, 0, 0, 0, 0, 0, 0
0, 0, 0, 0, 0, 0, 0, 0, 0, 0, 0, 0, 0
0, 0, 0, 0, 0, 0, 0, 0, 0, 0, 0, 0, 0
0, 0, 0, 0, 0, 0, 0, 0, 0, 0, 0, 0, 0
0, 0, 0, 0, 0, 0, 0, 0, 0, 0, 0, 0, 0
0, 0, 0, 0, 0, 0, 0, 0, 0, 0, 0, 0, 0
0, 0, 0, 0, 0, 0, 0, 0, 0, 0, 0, 0, 0
0, 0, 0, 0, 0, 0, 0, 0, 0, 0, 0, 0, 0
0, 0, 0, 0, 0, 0, 0, 0, 0, 0, 0, 0, 0
0, 0, 0, 0, 0, 0, 0, 0, 0, 0, 0, 0, 0
0, 0, 0, 0, 0, 0, 0, 0, 0, 0, 0, 0, 0
0, 0, 0, 21, 0, 0, 0, 0, 0, 0, 0, 0, 0
2, 2, 2, 2, 2, 2, 2, 2, 2, 5, 0, 0, 0
0, 0, 0, 0, 0, 0, 0, 0, 0, 0, 0, 0, 0
0, 0, 0, 0, 0, 0, 0, 0, 0, 0, 0, 0, 0
0, 0, 0, 0, 0, 0, 0, 0, 0, 0, 0, 1, 2
0, 0, 0, 0, 0, 0, 0, 0, 0, 0, 0, 0, 0
0, 0, 0, 0, 0, 0, 0, 0, 0, 0, 0, 0, 0
0, 0, 0, 0, 0, 0, 0, 0, 0, 0, 0, 0, 0
0, 0, 0, 0, 0, 0, 0, 0, 0, 0, 0, 0, 0
0, 0, 0, 0, 0, 0, 0, 0, 0, 0, 0, 0, 0
0, 0, 0, 9, 0, 0, 0, 0, 0, 0, 0, 0, 0
0, 80, 0, 0, 0, 93, 94, 0, 79, 80, 0, 0, 0
0, 0, 0, 0, 0, 0, 0, 0, 0, 0, 55, 0, 0
0, 0, 0, 0, 0, 0, 0, 0, 0, 0, 0, 0, 0
0, 0, 0, 0, 0, 0, 0, 0, 0, 0, 0, 0, 57
0, 0, 0, 0, 0, 0, 0, 0, 0, 0, 54, 0, 0